2 2 2 2 2 2 2 2 2 2 2 2 2 2 2 2 2 2 2 2 
2 2 2 2 2 2 2 2 2 2 0 2 2 2 2 2 2 2 2 2 
2 2 2 2 2 2 2 2 2 2 0 0 2 2 2 2 2 2 2 2 
2 2 2 2 2 2 2 2 2 2 0 0 2 2 2 2 2 2 2 2 
2 2 2 2 2 2 2 2 2 2 0 2 2 2 2 2 2 2 2 2 
2 2 2 2 2 2 2 2 2 2 0 2 2 2 2 2 2 2 2 2 
2 2 2 2 2 2 2 0 0 0 0 0 0 0 2 2 2 2 2 2 
2 2 2 2 2 2 2 2 2 2 0 2 2 2 2 2 2 2 2 2 
2 2 2 2 2 2 2 2 2 2 0 2 2 2 0 0 0 2 2 2 
2 2 2 0 0 0 0 0 0 2 0 2 2 0 0 2 0 0 2 2 
2 2 2 2 0 2 2 2 0 2 0 2 0 0 2 2 2 0 2 2 
2 2 2 2 0 2 2 2 0 2 0 2 0 2 2 2 2 0 2 2 
2 2 2 2 0 2 2 2 0 0 0 0 0 2 2 2 2 0 2 2 
2 2 2 2 0 2 2 2 2 0 0 0 0 0 0 2 2 0 2 2 
2 2 2 2 0 2 2 2 0 0 0 2 2 2 0 2 2 0 2 2 
2 2 2 2 0 2 2 2 0 2 0 2 0 2 0 2 2 0 2 2 
2 2 2 2 0 2 2 2 0 2 0 2 0 2 0 2 2 0 2 2 
2 2 2 2 0 0 0 0 0 2 0 0 0 2 0 0 0 0 2 2 
2 2 2 2 2 2 2 2 2 2 2 2 2 2 2 2 2 0 2 2 
2 2 2 2 2 2 2 2 2 2 2 2 2 2 2 2 2 2 2 2 

1 10
15 12
1
6 7
2
9 4
10 17
2
9 3 17 10
18 17 17 12
0