2 2 2 2 2 2 2 2 2 2 2 2 2 2 2 2 2 2 2 2 
2 0 0 0 0 0 0 0 0 0 0 2 2 2 2 2 2 2 0 2 
2 0 2 2 2 2 2 2 2 2 0 2 2 2 2 2 2 2 0 2 
2 0 2 0 0 0 2 0 0 2 0 0 2 2 2 2 0 0 0 2 
2 0 2 0 2 0 0 0 0 2 0 2 2 2 2 2 0 2 2 2 
2 0 2 0 2 2 2 0 0 2 0 2 0 0 0 0 0 2 2 2 
2 0 2 0 2 0 2 0 0 2 0 2 0 0 0 2 2 2 2 2 
2 0 2 0 0 0 2 0 2 2 0 2 0 0 0 2 2 2 2 2 
2 0 2 2 2 2 2 0 2 0 0 2 0 0 0 2 2 2 2 2 
2 0 0 0 0 0 0 0 2 0 2 2 0 0 0 2 2 2 2 2 
2 2 2 2 2 2 2 2 2 0 2 2 2 2 0 2 2 2 2 2 
2 2 2 0 0 0 0 0 0 0 2 2 2 2 0 0 2 2 2 2 
2 2 2 0 2 2 2 2 2 2 2 2 2 2 0 0 2 2 2 2 
2 2 2 0 2 0 2 0 2 0 2 2 2 2 2 0 2 2 2 2 
2 2 2 0 0 0 0 0 0 0 0 0 0 0 0 0 2 2 2 2 
2 2 2 2 2 0 2 0 2 0 2 2 2 2 2 2 2 2 2 2 
2 2 2 2 2 0 2 0 2 0 2 2 2 2 2 2 2 2 2 2 
2 2 2 2 2 0 2 0 2 0 2 2 2 2 2 2 2 2 2 2 
2 2 2 2 2 0 2 0 2 0 2 2 2 2 2 2 2 2 2 2 
2 2 2 2 2 2 2 2 2 2 2 2 2 2 2 2 2 2 2 2 

1 18
6 5
3
15 5
16 7
17 9
1
4 7
3
18 5 5 3
18 7 6 3
18 9 7 3
0