2 2 2 2 2 2 2 2 2 2 2 2 2 2 2 2 2 2 2 2
2 0 0 0 0 0 0 0 0 0 2 2 2 0 0 0 0 0 0 2 
2 0 0 0 0 0 0 0 0 0 2 2 2 0 2 2 2 2 0 2 
2 0 0 0 0 0 0 0 0 0 0 0 2 0 2 2 2 2 0 2 
2 0 0 0 0 0 0 0 0 0 2 0 2 0 2 2 2 2 0 2 
2 0 0 0 0 0 0 0 0 0 2 0 2 0 0 0 0 0 0 2 
2 0 0 0 0 0 0 0 0 0 2 0 2 2 2 2 2 2 0 2 
2 0 0 0 0 0 0 0 0 0 2 2 2 2 2 2 2 2 2 2 
2 2 2 2 0 2 2 0 2 2 2 2 2 2 2 2 2 2 2 2 
2 0 0 0 0 2 2 0 0 0 2 2 2 2 2 2 2 2 2 2 
2 2 2 2 2 2 2 2 2 2 2 2 2 2 2 2 2 2 2 2 
2 2 2 2 2 2 0 0 2 0 2 2 0 0 0 0 0 0 0 2 
2 2 2 2 2 0 0 0 2 0 0 0 0 0 0 0 0 0 0 2 
2 0 0 0 2 0 0 2 2 2 2 2 0 0 0 0 0 0 0 2 
2 0 0 0 2 0 2 2 2 2 2 2 2 0 0 0 0 0 0 2 
2 0 0 0 2 0 0 0 0 0 0 0 0 2 0 0 0 0 0 2 
2 0 0 0 2 2 2 2 0 2 2 0 2 0 0 0 0 0 0 2 
2 2 0 2 2 2 2 2 0 2 2 0 0 0 0 2 0 0 0 2 
2 2 0 2 0 0 0 0 0 2 2 2 2 2 2 2 2 2 2 2 
2 2 2 2 2 2 2 2 2 2 2 2 2 2 2 2 2 2 2 2 

18 2
18 4
3
1 2
15 5
15 12
4
9 2
5 18
12 12
12 13
2
6 18 16 11
9 1 14 5
5
13 3 1 9
7 1 1 13
2 13 17 18
11 9 9 9
9 2 17 16